3 0 2 2 2 2 2 2 2 2 2 2 2 2 2 2 2 2 0 3
0 0 2 2 2 2 2 2 2 2 2 2 2 2 2 2 2 2 0 0
2 2 2 2 2 2 2 2 2 2 2 2 2 2 2 2 2 2 2 2
2 2 2 2 2 2 2 2 2 2 2 2 2 1 1 1 2 2 2 2
2 2 2 1 1 1 2 2 2 2 2 2 2 1 1 1 2 2 2 2
2 2 2 1 1 1 2 2 2 2 2 2 2 1 1 1 2 2 2 2
2 2 2 1 1 1 2 1 1 0 1 1 2 2 2 2 2 2 2 2
2 2 2 2 2 2 2 1 6 12 10 1 2 2 2 2 2 2 2 2
2 2 2 2 2 2 2 0 12 12 12 0 2 2 2 2 2 2 2 2
2 2 2 2 2 2 2 1 8 12 4 1 2 2 2 2 2 2 2 2
2 2 2 1 1 1 2 1 1 0 1 1 2 1 1 1 2 2 2 2
2 2 2 1 1 1 2 2 2 2 2 2 2 1 1 1 2 2 2 2
2 2 2 1 1 1 2 2 2 2 2 2 2 1 1 1 2 2 2 2
2 2 2 2 2 2 2 2 2 2 2 2 2 2 2 2 2 2 2 2
2 2 2 2 2 2 2 2 2 2 2 2 2 2 2 2 2 2 2 2
2 2 2 2 2 2 2 2 2 2 2 2 2 2 2 2 2 2 2 2
2 2 2 2 2 2 2 2 2 2 2 2 2 2 2 2 2 2 2 2
2 2 2 2 2 2 2 2 2 2 2 2 2 2 2 2 2 2 2 2
0 0 2 2 2 2 2 2 2 2 2 2 2 2 2 2 2 2 0 0
3 0 2 2 2 2 2 2 2 2 2 2 2 2 2 2 2 2 0 3