3 6 4 10 0 0 0 0 0 0 0 0 0 0 0 10 2 4 6 3
6 6 4 10 0 0 0 0 0 0 0 0 0 0 0 10 2 4 6 6
4 4 4 10 0 0 0 0 0 0 0 0 0 0 0 10 2 4 4 4
8 8 8 8 0 0 0 0 0 0 0 0 0 0 0 10 2 2 2 2
0 0 0 0 0 0 0 0 0 0 0 0 0 0 0 0 8 8 8 8
0 0 0 0 0 0 0 0 0 0 0 0 0 0 0 0 0 0 0 0
0 0 0 0 0 0 0 0 0 6 12 0 0 0 0 0 0 0 0 0
0 0 0 0 0 0 0 0 0 12 12 12 0 0 0 0 0 0 0 0
0 0 0 0 0 0 0 0 0 6 12 6 0 0 0 0 0 0 0 0
0 0 0 0 0 0 0 0 0 0 0 0 0 0 0 0 0 0 0 0
0 0 0 0 0 0 0 0 0 0 0 0 0 0 0 0 0 0 0 0
0 0 0 0 0 0 0 0 0 0 0 0 0 0 0 0 0 0 0 0
0 0 0 0 0 0 0 0 0 0 0 0 0 0 0 0 0 0 0 0
0 0 0 0 0 0 0 0 0 0 0 0 0 0 0 0 0 0 0 0
0 0 0 0 0 0 0 0 0 0 0 0 0 0 0 0 0 0 0 0
0 0 0 0 0 0 0 0 0 0 0 0 0 0 0 0 8 0 0 0
10 10 10 8 0 0 0 0 0 0 0 0 0 0 0 0 8 10 10 10
4 4 4 8 0 0 0 0 0 0 0 0 0 0 0 0 8 4 4 4
6 6 4 8 0 0 0 0 0 0 0 0 0 0 0 0 8 4 6 6
3 6 4 8 0 0 0 0 0 0 0 0 0 0 0 0 8 4 6 3