3 6 4 0 0 0 0 0 0 0 0 0 0 0 0 0 0 4 6 3
6 6 4 0 0 0 0 0 0 0 0 0 0 0 0 0 0 4 6 6
4 4 4 0 0 0 0 0 0 0 0 0 0 0 0 0 0 4 4 4
0 0 0 0 0 0 0 0 0 0 0 0 0 0 0 0 0 0 0 0
0 0 0 0 0 0 0 0 0 0 0 0 0 0 0 0 0 0 0 0
0 0 0 0 0 0 0 0 0 0 0 0 0 0 0 0 0 0 0 0
0 0 0 0 0 0 0 0 0 6 12 0 0 0 0 0 0 0 0 0
0 0 0 0 0 0 0 0 0 12 12 12 0 0 0 0 0 0 0 0
0 0 0 0 0 0 0 0 0 6 12 6 0 0 0 0 0 0 0 0
0 0 0 0 0 0 0 0 0 0 0 0 0 0 0 0 0 0 0 0
0 0 0 0 0 0 0 0 0 0 0 0 0 0 0 0 0 0 0 0
0 0 0 0 0 0 0 0 0 0 0 0 0 0 0 0 0 0 0 0
0 0 0 0 0 0 0 0 0 0 0 0 0 0 0 0 0 0 0 0
0 0 0 0 0 0 0 0 0 0 0 0 0 0 0 0 0 0 0 0
0 0 0 0 0 0 0 0 0 0 0 0 0 0 0 0 0 0 0 0
0 0 0 0 0 0 0 0 0 0 0 0 0 0 0 0 0 0 0 0
0 0 0 0 0 0 0 0 0 0 0 0 0 0 0 0 0 0 0 0
4 4 4 0 0 0 0 0 0 0 0 0 0 0 0 0 0 4 4 4
6 6 4 0 0 0 0 0 0 0 0 0 0 0 0 0 0 4 6 6
3 6 4 0 0 0 0 0 0 0 0 0 0 0 0 0 0 4 6 3